- - - - - - - - - - - - - - - -
- - - - T T - - - - - - - - - -
- - - U G G I T T - - - - - - -
- - L G G G G G G T - - - - - -
- - L G G G G G G G I T - - - -
- - - J G G G G G G G G R - - -
- - - - B J G G G G G G I - - -
- - - - - - B B J G G G G R - -
- - - - - - - - - B J G G R - -
- - - - - - - - - - - B B - - -
