- - - T T - - - - - - - - - - -
- - U G G I T E - - - - - - - -
- L G G G G G R - - - - - - - -
- L G G G G G I T E - - - - - -
- A B J G G G G G R - - - - - -
- - - L G G G G G R - - - - - -
- - Q T M M M G G R - - - - - -
- - L G G G G G K - - - - - - -
- - L G G G G G R - - - - - - -
- - A B B B B B D - - - - - - -
